owl:Thing	Entity
Activity	Process
Game	Game
BoardGame	Game
CardGame	Game
Sales	FinancialTransaction
Sport	Sport
Athletics	Sport
TeamSport	TeamSport
Agent	Agent
Deity	Deity
Employer	Agent	(employs is a relationship)
Family	FamilyGroup
NobleFamily	FamilyGroup
FictionalCharacter	Agent
ComicsCharacter	Agent
AnimangaCharacter	Agent
DisneyCharacter	Agent
MythologicalFigure	Agent
NarutoCharacter	Agent
SoapCharacter	Agent
Organisation	Organisation
Broadcaster	Agent	(these are SocialRole instances in SUMO)
BroadcastNetwork	BroadcastNetwork
RadioStation	RadioStation
TelevisionStation	TelevisionStation
Company	Business
Bank	FinancialCompany
Brewery	Business
Caterer	Business
LawFirm	Business
PublicTransitSystem	TransportationCompany
Airline	Airline
BusCompany	TransportationCompany
Publisher	Publisher
RecordLabel	RecordLabel
Winery	Business
EducationalInstitution	EducationalOrganization
College	College
Library	Library
School	School
University	University
EmployersOrganisation	Organization
GeopoliticalOrganisation	Organization
GovernmentAgency	GovernmentOrganization
GovernmentCabinet	GovernmentOrganization
Group	GroupOfPeople
Band	MusicalGroup
ComedyGroup	GroupOfPeople
InternationalOrganisation	Organization
Legislature	GovernmentOrganization
MilitaryUnit	MilitaryUnit
Non-ProfitOrganisation	Organization
RecordOffice	Organization
Parliament	GovernmentOrganization
PoliticalParty	PoliticalParty
ReligiousOrganisation	ReligiousOrganization
ClericalOrder	ReligiousOrganisation
SambaSchool	EducationalOrganization
SportsClub	SportsTeam
HockeyClub	SportsTeam
RugbyClub	RugbyTeam
SoccerClub	SoccerTeam
NationalSoccerClub	SoccerTeam
SportsLeague	SportsLeague
AmericanFootballLeague	SportsLeague
AustralianFootballLeague	SportsLeague
AutoRacingLeague	SportsLeague
BaseballLeague	SportsLeague
BasketballLeague	SportsLeague
BowlingLeague	SportsLeague
BoxingLeague	SportsLeague
CanadianFootballLeague	SportsLeague
CricketLeague	SportsLeague
CurlingLeague	SportsLeague
CyclingLeague	SportsLeague
FieldHockeyLeague	SportsLeague
FormulaOneRacing	SportsLeague
GolfLeague	SportsLeague
HandballLeague	SportsLeague
IceHockeyLeague	SportsLeague
InlineHockeyLeague	SportsLeague
LacrosseLeague	SportsLeague
MixedMartialArtsLeague	SportsLeague
MotorcycleRacingLeague	SportsLeague
PaintballLeague	SportsLeague
PoloLeague	SportsLeague
RadioControlledRacingLeague	SportsLeague
RugbyLeague	SportsLeague
SoccerLeague	SportsLeague
SoftballLeague	SportsLeague
SpeedwayLeague	SportsLeague
TennisLeague	SportsLeague
VideogamesLeague	SportsLeague
VolleyballLeague	SportsLeague
SportsTeam	SportsTeam
AmericanFootballTeam	FootballTeam
AustralianFootballTeam	SportsTeam
BaseballTeam	BaseballTeam
BasketballTeam	BasketballTeam
CanadianFootballTeam	FootballTeam
CricketTeam	SportsTeam
CyclingTeam	SportsTeam
FormulaOneTeam	SportsTeam
HandballTeam	SportsTeam
HockeyTeam	SportsTeam
SpeedwayTeam	SportsTeam
TermOfOffice	Time
TradeUnion	Organization
Person	Human
Archeologist	Archeologist	(note that all Occupations are instances of SocialRole)
Architect	Architect
Aristocrat	SocialRole
Artist	ArtisticOccupation
Actor	Actor
AdultActor	Actor
VoiceActor	VoiceActor
Comedian	Comedian
ComicsCreator	ArtisticOccupation
Dancer	Dancer
FashionDesigner	Designer
Humorist	Writer
MusicalArtist	Musician
BackScene	ArtisticOccupation
ClassicalMusicArtist	Musician
Instrumentalist	Musician
Guitarist	Guitarist
MusicDirector	ArtisticOccupation
Singer	Musician
Painter	Painter
Photographer	ArtisticOccupation
Sculptor	Sculptor
Astronaut	Astronaut
Athlete	SportsPosition
ArcherPlayer	SportsPosition
AthleticsPlayer	SportsPosition
AustralianRulesFootballPlayer	SportsPosition
BadmintonPlayer	SportsPosition
BaseballPlayer	BaseballPlayer
BasketballPlayer	BasketballPlayer
Bodybuilder	SportsPosition
Boxer	Boxer
AmateurBoxer	SocialRole
BullFighter	SportsPosition
Canoeist	SportsPosition
ChessPlayer	SocialRole
Cricketer	Cricketer
Cyclist	Cyclist
DartsPlayer	SportsPosition
Fencer	SportsPosition
GaelicGamesPlayer	SportsPosition
GolfPlayer	Golfer
GridironFootballPlayer	SportsPosition
AmericanFootballPlayer	FootballerUS
CanadianFootballPlayer	SportsPosition
Gymnast	Gymnast
HandballPlayer	SportsPosition
HighDiver	SportsPosition
HorseRider	SportsPosition
Jockey	SportsPosition
LacrossePlayer	LacrossePlayer
MartialArtist	SportsPosition
MotorsportRacer	SportsPosition
MotorcycleRider	MotorcycleRider
MotocycleRacer	MotorcycleRider
SpeedwayRider	RacingCarDriver
RacingDriver	RacingCarDriver
DTMRacer	RacingCarDriver
FormulaOneRacer	RacingCarDriver
NascarDriver	RacingCarDriver
RallyDriver	RacingCarDriver
NationalCollegiateAthleticAssociationAthlete	SportsPosition
NetballPlayer	SportsPosition
PokerPlayer	SocialRole
Rower	SportsPosition
RugbyPlayer	RugbyPlayer
SnookerPlayer	SportsPosition
SnookerChamp	SportsPosition
SoccerPlayer	FootballerSoccer
SquashPlayer	SportsPosition
Surfer	SportsPosition
Swimmer	Swimmer
TableTennisPlayer	SportsPosition
TeamMember	SportsPosition
TennisPlayer	TennisProfessional
VolleyballPlayer	SportsPosition
BeachVolleyballPlayer	SportsPosition
WaterPoloPlayer	SportsPosition
WinterSportPlayer	SportsPosition
Biathlete	SportsPosition
BobsleighAthlete	SportsPosition
CrossCountrySkier	SportsPosition
Curler	SportsPosition
FigureSkater	FigureSkater
IceHockeyPlayer	IceHockeyPlayer
NordicCombined	SportsPosition
Skater	SportsPosition
Ski_jumper	SportsPosition
Skier	SportsPosition
SpeedSkater	SportsPosition
Wrestler	Wrestler
SumoWrestler	Wrestler
BeautyQueen	SocialRole
BusinessPerson	Wrestler
Celebrity	Wrestler
Chef	Chef
Cleric	Cleric
Cardinal	Cardinal
ChristianBishop	Bishop
Archbishop	Bishop
ChristianPatriarch	ReligiousPosition
Pope	Pope
Priest	Cleric
Saint	ReligiousPosition
Vicar	ReligiousPosition
Coach	Coach
AmericanFootballCoach	Coach
CollegeCoach	Coach
VolleyballCoach	Coach
Criminal	Criminal
Murderer	Criminal
SerialKiller	Criminal
Economist	Economist
Egyptologist	Scientist
Engineer	Scientist
Farmer	OccupationalRole
HorseTrainer	OccupationalRole
Journalist	Journalist
Judge	Judge
Lawyer	Lawyer
Linguist	Linguist
MemberResistanceMovement	SocialRole
MilitaryPerson	MilitaryPerson
Model	OccupationalRole
Monarch	Monarch
MovieDirector	ArtisticOccupation
Noble	SocialRole
OfficeHolder	GovernmentPerson
OrganisationMember	Position
SportsTeamMember	SportsPosition
Philosopher	Philosopher
PlayboyPlaymate	EntertainmentProfession
Politician	GovernmentPerson
Ambassador	Diplomat
Chancellor	GovernmentPerson
Congressman	GovernmentPerson
Deputy	GovernmentPerson
Governor	Governor
Lieutenant	GovernmentPerson
Mayor	Mayor
MemberOfParliament	GovernmentPerson
Minister	GovernmentPerson
President	GovernmentPerson
PrimeMinister	GovernmentPerson
Senator	GovernmentPerson
VicePresident	GovernmentPerson
VicePrimeMinister	GovernmentPerson
PoliticianSpouse	SocialRole
Presenter	SkilledOccupation
RadioHost	SkilledOccupation
TelevisionHost	SkilledOccupation
Producer	SkilledOccupation
Psychologist	Psychologist
Referee	SocialRole
Religious	SocialRole
RomanEmperor	Leader
Royalty	SocialRole
BritishRoyalty	SocialRole
Baronet	SocialRole
Scientist	Scientist
Biologist	Biologist
Entomologist	Biologist
Medician	Scientist
Professor	Scientist
SportsManager	SportsManager
SoccerManager	SportsManager
TelevisionDirector	Manager
TheatreDirector	Manager
Writer	Writer
Historian	Historian
MusicComposer	Composer
PlayWright	Writer
Poet	Writer
ScreenWriter	Writer
SongWriter	Composer
Altitude	a Relation and not a Class
AnatomicalStructure	AnatomicalStructure
Artery	Artery
BloodVessel	BloodVessel
Bone	Bone
Brain	Brain
Embryology	Embryonic	(an Attribute and not a Class)
Ligament	AnimalAnatomicalStructure
Lymph	Gland
Muscle	Muscle
Nerve	AnimalAnatomicalStructure
Vein	Vein
Area	AreaMeasure	(referring to a particular UnifOfMeasure)
Award	Proposition
Decoration	Proposition
NobelPrize	Proposition
Biomolecule	BiologicallyActiveSubstance
Enzyme	Enzyme
Gene	DNAMolecule
HumanGene	DNAMolecule
MouseGene	DNAMolecule
Hormone	Hormone
Lipid	BiologicallyActiveSubstance
Polysaccharide	Carbohydrate
Protein	Protein
Blazon	Icon
ChartsPlacements	Icon
ChemicalSubstance	Substance
ChemicalCompound	CompoundSubstance
ChemicalElement    	ElementalSubstance
Drug	Medicine
CombinationDrug	Medicine
MonoclonalAntibody	Antibody
Vaccine	Medicine
Mineral	Mineral
Colour	ColorAttribute
Currency	Currency
Demographics	GroupOfPeople
Depth	LengthMeasure	(depth is a relationship)
Device	Device
Battery	Battery
Camera	Camera
DigitalCamera	Camera
Engine	Engine
AutomobileEngine	Engine
RocketEngine	Camera
InformationAppliance	Computer
Instrument	MusicalInstrument
Guitar	Guitar
Organ	MusicalInstrument
MobilePhone	MobileCellPhone
Weapon	Weapon
Diploma	AcademicDegree
Disease	DiseaseOrSyndrome
ElectionDiagram	Icon
ElectricalSubstation	ElectricDevice
EthnicGroup	EthnicGroup
Event	Process
Competition	Contest
Contest	Contest
LifeCycleEvent	Process
PersonalEvent	Process
Birth	Birth
Death	Death
Divorce	Divorcing
Marriage	Declaring
NaturalEvent	NaturalProcess
Earthquake	Earthquake
SolarEclipse	NaturalProcess
StormSurge	WaterMotion
PenaltyShootOut	GameShot
SocietalEvent	SocialInteraction
AcademicConference	FormalMeeting
Attack	ViolentContest
Convention	FormalMeeting
Election	Election
FilmFestival	Meeting
HistoricalEvent	Process
Meeting	Meeting
MilitaryConflict	Battle
MusicFestival	Meeting
Rebellion	ViolentContest
SpaceMission	SpaceTransportation
SportsEvent	Sport
CyclingCompetition	Cycling
FootballMatch	Soccer
GrandPrix	Racing
InternationalFootballLeagueEvent	Soccer
MixedMartialArtsEvent	MartialArts
NationalFootballLeagueEvent	Soccer
Olympics	OlympicGames
OlympicEvent	OlympicGames
Race	Racing
CyclingRace	Cycling
HorseRace	HorseRacing
MotorRace	Racing
Tournament	Contest
GolfTournament	Golf
SoccerTournament	Soccer
TennisTournament	Tennis
WomensTennisAssociationTournament	Tennis
WrestlingEvent	MartialArts
Flag	Flag
Food	Food
Beverage	Beverage
Beer	Beer
Vodka	Vodka
Wine	Wine
ControlledDesignationOfOriginWine	Wine
Cheese	Cheese
GeneLocation	Region
HumanGeneLocation	Cheese
MouseGeneLocation	Cheese
GrossDomesticProduct	FunctionQuantity
GrossDomesticProductPerCapita	FunctionQuantity
Holiday	Holiday
HumanDevelopmentIndex	RealNumber
Identifier	Identifier
TopLevelDomain	IPAddress
Language	Language
ProgrammingLanguage	ComputerLanguage
List	List
TrackList	List
MeanOfTransportation	TransportationDevice
Aircraft	Aircraft
MilitaryAircraft	Aircraft
Automobile	Automobile
Locomotive	Locomotive
MilitaryVehicle	MilitaryVehicle
Motorcycle	Motorcycle
On-SiteTransportation	TransportationDevice
ConveyorSystem	TransportationDevice
Escalator	TransportationDevice
MovingWalkway	TransportationDevice
Rocket	Rocket
Ship	Ship
SpaceShuttle	Spacecraft
SpaceStation	Spacecraft
Spacecraft	Spacecraft
Train	Train
TrainCarriage	RailVehicle
Tram	TransportationDevice
Media	DigitalData
MedicalSpecialty	MedicalScience
Medicine	MedicalScience
Name	Name
GivenName	Name
Surname	Name
PersonFunction	SocialRole
PoliticalFunction	Position
Profession	Profession
Place	Region
ArchitecturalStructure	StationaryArtifact
AmusementParkAttraction	RecreationOrExerciseDevice
RollerCoaster	RecreationOrExerciseDevice
WaterRide	RecreationOrExerciseDevice
Arena	Building
Building	Building
Casino	Casino
Castle	Building
Factory	Building
HistoricBuilding	Building
Hospital	HospitalBuilding
Hotel	HotelBuilding
Museum	Museum
Prison	Prison
ReligiousBuilding	ReligiousBuilding
Church	ChurchBuilding
Monastery	ReligiousBuilding
Mosque	Mosque
Shrine	ReligiousBuilding
Synagogue	Synagogue
Temple	ReligiousBuilding
Restaurant	RestaurantBuilding
ShoppingMall	ShoppingMall
Skyscraper	HighRise
Venue	Building
Cinema	Building
Stadium	SportsFacility
Theatre	Building
Infrastructure	StationaryArtifact
Airport	Airport
Dam	Dam
Dike	Dam
LaunchPad	StationaryArtifact
Lock	CanalLock
Port	PortFacility
PowerStation	StationaryArtifact
NuclearPowerStation	StationaryArtifact
ProductionPlant	StationaryArtifact
RestArea	StationaryArtifact
RouteOfTransportation	Transitway
Bridge	Bridge
RailwayLine	RailTransportationSystem
RailwayTunnel	Tunnel
Road	Roadway
RoadJunction	RoadJunction
RoadTunnel	Tunnel
WaterwayTunnel	Tunnel
Station	TransitTerminal
MetroStation	RailwayTerminal
RailwayStation	RailwayTerminal
RouteStop	TransitTerminal
TramStation	RailwayTerminal
MilitaryStructure	StationaryArtifact
Fort	StationaryArtifact
Mill	StationaryArtifact
Treadmill	Device
Watermill	StationaryArtifact
WindMotor	Windmill
Windmill	Windmill
Monument	Monument
GraveMonument	Monument
Memorial	Monument
Pyramid	StationaryArtifact
SportFacility	SportsFacility
CricketGround	SportsFacility
GolfCourse	GolfCourse
RaceTrack	SportsFacility
Racecourse	SportsFacility
SkiArea	SkiingFacility
SkiResort	SkiingFacility
Square	StationaryArtifact
Tower	StationaryArtifact
Lighthouse	StationaryArtifact
WaterTower	FluidContainer
Tunnel	Tunnel
Zoo	AnimalResidence
CelestialBody	AstronomicalBody
Asteroid	AstronomicalBody
Constellation	AstronomicalBody
Galaxy	AstronomicalBody
Planet	Planet
Satellite	Satellite
ArtificialSatellite	ArtificialSatellite
Star	Star
BrownDwarf	Star
Swarm	AstronomicalBody
Globularswarm	AstronomicalBody
Openswarm	AstronomicalBody
Cemetery	Cemetery
ConcentrationCamp	Prison
CountrySeat	LandArea
Garden	CultivatedLandArea
HistoricPlace	StationaryArtifact
Mine	Mine
CoalPit	Mine
NaturalPlace	Region
Archipelago	Archipelago
Beach	ShoreArea
BodyOfWater	BodyOfWater
Bay	Bay
Lake	Lake
Ocean	Ocean
Sea	Sea
Stream	StreamWaterArea
Canal	Canal
Creek	Creek
River	River
Cape	Cape
Cave	Cave
Crater	Hole
LunarCrater	Hole
Desert	Desert
Forest	Forest
Glacier	Glacier
HotSpring	WaterArea
Mountain	Mountain
MountainPass	MountainousTerrain
MountainRange	MountainRange
Valley	Valley
Volcano	Volcano
Park	Park
PopulatedPlace	GeographicRegion
Agglomeration	GeographicRegion
Community	GeographicRegion
Continent	Continent
Country	Nation
HistoricalCountry	Nation
GatedCommunity	GeographicRegion
Intercommunality	GeographicRegion
Island	Island
Atoll	Atoll
Locality	GeographicRegion
Region	GeographicRegion
AdministrativeRegion	GeopoliticalArea
ClericalAdministrativeRegion	GeopoliticalArea
Deanery	GeopoliticalArea
Diocese	GeopoliticalArea
Parish	GeopoliticalArea
GovernmentalAdministrativeRegion	GeopoliticalArea
Arrondissement	GeopoliticalArea
Canton	GeopoliticalArea
Department	GeopoliticalArea
OverseasDepartment	GeopoliticalArea
District	CityDistrict
HistoricalDistrict	CityDistrict
DistrictWaterBoard	GeopoliticalArea
MicroRegion	GeopoliticalArea
Municipality	GeopoliticalArea
FormerMunicipality	GeopoliticalArea
Prefecture	GeopoliticalArea
Province	StateOrProvince
HistoricalProvince	StateOrProvince
Regency	GeopoliticalArea
SubMunicipality	GeopoliticalArea
HistoricalAreaOfAuthority	GeopoliticalArea
Fiefdom	GeopoliticalArea
HistoricalRegion	GeopoliticalArea
NaturalRegion	GeographicRegion
Settlement	GeographicRegion
City	City
Capital	City
CapitalOfRegion	City
CityDistrict	CityDistrict
HistoricalSettlement	GeographicRegion
Town	City
Village	City
State	StateOrProvince
Street	Street
Territory	GeopoliticalArea
OldTerritory	GeopoliticalArea
ProtectedArea	GeographicRegion
SiteOfSpecialScientificInterest	GeographicRegion
WineRegion	CultivatedLandArea
WorldHeritageSite	GeographicRegion
Population	GroupOfPeople
PublicService	SocialInteraction
Relationship	Relation
Ratio	PerFn
Species	Organism
Archaea	Organism
Bacteria	Bacterium
Eukaryote	EukaryoticCell
Animal	Animal
Amphibian	Amphibian
Arachnid	Arachnid
Bird	Bird
Crustacean	Crustacean
Fish	Fish
Insect	Insect
Mammal	Mammal
Cat	DomesticCat
Dog	DomesticDog
Horse	Horse
Mollusca	Mollusk
Reptile	Reptile
Fungus	Fungus
Plant	Plant
ClubMoss	Moss
Conifer	BotanicalTree
CultivatedVariety	Plant
Cycad	Plant
Fern	Fern
FloweringPlant	FloweringPlant
Grape	FloweringPlant
Ginkgo	Gnetophytes
Gnetophytes	Gnetophytes
GreenAlga	Alga
Moss	Moss
SportCompetitionResult	ConstantQuantity
OlympicResult	ConstantQuantity
SnookerWorldRanking	ConstantQuantity
SportsSeason	TimeInterval
MotorsportSeason	TimeInterval
SportsTeamSeason	TimeInterval
BaseballSeason	TimeInterval
FootballLeagueSeason	TimeInterval
NationalFootballLeagueSeason	TimeInterval
NCAATeamSeason	TimeInterval
SoccerClubSeason	TimeInterval
SoccerLeagueSeason	TimeInterval
Statistic	PhysicalQuantity
TimePeriod	TimeInterval
CareerStation	TimeInterval
MilitaryService	TimeInterval
GeologicalPeriod	TimeInterval
HistoricalPeriod	TimeInterval
PeriodOfArtisticStyle	TimeInterval
PrehistoricalPeriod	TimeInterval
ProtohistoricalPeriod	TimeInterval
Reign	TimeInterval
Tenure	TimeInterval
Year	Year
YearInSpaceflight	Year
TopicalConcept	FieldOfStudy
AcademicSubject	FieldOfStudy
CardinalDirection	DirectionalAttribute
Fashion	FieldOfStudy
Genre	RelationalAttribute
ArtisticGenre	RelationalAttribute
LiteraryGenre	RelationalAttribute
MovieGenre	RelationalAttribute
MusicGenre	MusicGenre
Ideology	Proposition
MathematicalConcept	Proposition
PhilosophicalConcept	Proposition
PoliticalConcept	Proposition
ScientificConcept	Proposition
Standard	Proposition
SystemOfLaw	LegalSystemAttribute
Tax	LegalSystemAttribute
Taxon	Organism
TheologicalConcept	Proposition
ChristianDoctrine	Proposition
Type	Class
DocumentType	RelationalAttribute
GovernmentType	FormOfGovernment
UnitOfWork	Process
Case	OrganizationalProcess
LegalCase	LegalAction
SupremeCourtOfTheUnitedStatesCase 	LegalAction
Project	Process
ResearchProject	Investigating
Unknown	Entity
WikimediaTemplate	Entity
Work	ContentBearingPhysical
Artwork	ArtWork
Painting	PaintedPicture
Sculpture	Sculpture
Cartoon	ArtWork
Anime	MotionPicture
HollywoodCartoon	MotionPicture
CollectionOfValuables	Collection
Archive	Document
Database	Database
BiologicalDatabase	Database
Document	Document
File	ComputerFile
Image	Icon
MovingImage	MotionPicture
StillImage	Icon
Sound	AudioFile
Film	MotionPicture
LineOfFashion	WearableItem
MusicalWork	Music
Album	Album
ArtistDiscography	MotionPicture
ClassicalMusicComposition	MotionPicture
Musical	Song
NationalAnthem	Song
Opera	Opera
Single	Song
Song	Song
EurovisionSongContestEntry	Song
RadioProgram	RadioBroadcasting
Software	Software
VideoGame	VideoGame
TelevisionEpisode	TelevisionBroadcasting
TelevisionSeason	TelevisionBroadcasting
TelevisionShow	TelevisionBroadcasting
Website	Website
WrittenWork	Text
Annotation	Text
Reference	Text
Article	Article
Book	Book
Novel	Novel
LightNovel	Novel
Comic	Text
ComicStrip	Text
Manga	Text
Manhua	Text
Manhwa	Text
Drama	DramaticPlay
Law	Law
Letter	Character
MultiVolumePublication	Series
PeriodicalLiterature	Periodical
AcademicJournal	Periodical
Magazine	Magazine
Newspaper	Newspaper
UndergroundJournal	Periodical
Play	DramaticPlay
Poem	Text
Quote	Text
Resume	FactualText
StatedResolution	Report
Treaty	Treaty
foaf:Document	Text
cidoccrm:E4_Period	TimeInterval
d0:Activity	Process
foaf:Image	Image
foaf:Person	Human
geo:SpatialThing	Object
gml:_Feature	Attribute
rdf:Property	Attribute
skos:Concept	Class
skos:OrderedCollection	List
